000000002452000000000000000002452000000000
222222222112222222220222222222112222222220
211111211111211111120211111211111211111120
222122221112222112220222122221112222112220
212111111111111111120212111111111111111120
211122222222221122220212111111111111111120
211211112111111111122212111111111111111120
221221112111111222111111111111111111111120
211111111112222221111111111111111111111120
222211222111111111222212111111111111111120
211111211111222122220212111111111111111120
221211221111221111120212111111111111111120
211211112222211111120212111111111111111120
211111111221111111120212111111111111111120
211211111111111111120212111111111111111120
222222222112222222220222222222112222222220
222222222112222222220222222222112222222220
211111211111211111120211111211111211111120
222122221112222112220222122221112222112220
212111111111111111120212111111111111111120
211122222222221122220212111111111111111120
211211112111111111122212111111111111111120
221221112111111222111111111111111111111120
211111111112222221111111111111111111111120
222211222111111111222212111111111111111120
211111211111222122220212111111111111111120
221211221111221111120212111111111111111120
211211112222211111120212111111111111111120
211111111221111111120212111111111111111120
211211111111111111120212111111111111111120
22222222222222222222022222222222222222222