22222222245222222222
21111121111121111112
22212222122222211222
21211111112111111112
21112222222222112222
21121111211111111112
22122111211111122212
21111111111222222112
22221122212111111122
21111121111122212222
22121122111122111112
21121111222221111112
21111111122111111112
21121111111111111112
22222222222222222222